+~~~~~~~~~~~~~~~~ Return to NEVERWHERE ~~~~~~~~~~~~~~~~~+
|#######################################################|
|#            ########       ##################       ##|
|##    ###############                  ######         #|
|##   ################           ######  #######      ##|
|##  #######################  ########   ########   ####|
|##  #######################   ########   ######   #####|
|##  #######################  ######    #   ##   #######|
|##  #######################  ######   ###      ########|
|##             ############  #######   ####    ########|
|###########  #########            ####  ######   ######|
|###########  #######         ########  ########    ####|
|###########  #######         ###       #####      #####|
|###########  #######           ##    ###     ##########|
|###########  #############      ##  ###         #######|
|###########  ################    ######         #######|
|##              ###########       ##########  #########|
|##  #########  ############   ##############  #########|
|##  #########  #############  #############  ##########|
|##  #########  ###########   ##############  ##########|
|##  #####################  ###############    #########|
|###  ####################   ################     ######|
|####   ###################   ###################   ####|
|######   ##############            ##########     #####|
|########   ############  ###################   ########|
|##########  ###########  ###################   ########|
|##########  ###########   ###################      ####|
|##########                        ###############  ####|
|############### #################################   ###|
|############### #################################  ####|
|######                          #################  ####|
|######                          #################      |
|#######################################################|
+-------------------------------------------------------+