+~~~~~~~~~~~~~~~~ Return to NEVERWHERE ~~~~~~~~~~~~~~~~~+
|#######################################################|
|#            ########       ##################       ##|
|##    ###########%%%%%%%               ######         #|
|##   #######%%%%%%%%%%%%%%%%    ######  #######      ##|
|##  ########%%%%%%#########  ########   ########   ####|
|##  #######################   ########   ######   #####|
|##  #######################  ######    #   ##   #######|
|##  #######################  ######   ###      ########|
|##             ############  #######   ####    ########|
|###########  #########            ####  ######   ######|
|###########  #######   %%%%% ########  ########    ####|
|###########  #######   %%%   ###       #####      #####|
|###########  ####### %%%%      ##    ###      #########|
|###########  #############      ##  ###  %%%%   #######|
|###########  ################    ######  %%%%   #######|
|##              ###########       ##########  #########|
|##  ##%%%%%##  ############   ##############  #########|
|##  #%%%%%###  #############  #############  ##########|
|##  ###%%%%###  ###########   #############  ##########|
|##  #####################  ###############    #########|
|###  ####################   ################     ######|
|####   ###################   ###################   ####|
|######   ##############            ##########     #####|
|########   ############  ###################   ########|
|##########  ###########  ###################   ########|
|##########  ###########  %%%%%%##############      ####|
|##########                        ###############  ####|
|############### #################################   ###|
|############### #################################  ####|
|######                          #################  ####|
|######                          #################  GGGG|
|#######################################################|
+-------------------------------------------------------+