+~~~~~~~~~~~~~~~~ Return to NEVERWHERE ~~~~~~~~~~~~~~~~~+
|#######################################################|
|#            ########       ##################       ##|
|##    ###########%%%%%%%               ######         #|
|##   #######%%%%%%%%%%%%%%%%    ######   ######      ##|
|##  #######################  ######    #   ##   #######|
|##  #######################  ######   ###      ########|
|##             ############  #######   ####    ########|
|###########  #########            ####  ######   ######|
|###########  #######   %%%%% ######    ########    ####|
|###########  ####### %%%%      ##    ###        #######|
|###########  ################     #####  %%%%   #######|
|##              ###########       ##########  #########|
|##  ##%%%%%##  ############   ##############  #########|
|##  ###%%%%###  ###########   #############  ##########|
|##  #####################    #############    #########|
|###     #################   ################     ######|
|######   ##############            ##########     #####|
|########   ############  ###################   ########|
|##########  ###########  %%%%%%##############      ####|
|##########                        ###############  ####|
|############### #################################   ###|
|######                          #################  ####|
|######                          #################  GGGG|
|#######################################################|
+-------------------------------------------------------+